XXXXXXXXXX
X*    O  X
XXX  X   X
X    X   X
X  XXXXX X
X     O  X
X        X
X   X    X
X XXX    X
X   X XXXX
X   XXX  X
X X      X
X XXOXX  X
X     $  X
XXXXXXXXXX